#############################################
#############################################
####################........###...###########
####################........###...###########
###############...................###########
###...#......##.####........#####.###########
###...#.####.##.####........#####.###########
###.....####....#################.###########
#######.####.####################.###########
#######....#.####################.###########
##########.#.####################.###########
##########.#......###############.###########
##########.#.####.###############.###########
###........#.####........##...............###
###...######.####.####........######.####.###
###..........####.#####.####.#######.####.###
###.########.####.#####.############.####.###
###.########.####.#####.##########....###.###
###.########......#####.##########.##.###.###
###.########.##########...########.##.###..##
##...#######.##########...########..#.###..##
##...#######.###########..#########.#......##
##.......###.........####.#########.#####..##
##.#####.#####.#####.####.#########.#####.###
##.#####.#####.#####.####.#########.#####.###
##.#####.#####.#####.##.....###.....#####.###
##.#.....#####.#####.##.....###...#######.###
##.#.###.###.....###..............#######.###
##.#.###.###.....##############...........###
##.#.###.........###############..###########
##...#######.....################.###########
##...#######.....################.###########
##...###########.################...#########
################....................#########
#############################################
#############################################